..............
..............
.X............
###.G.G.......
....G.G..GGG..
G.G.---..G.G..
G.G......###..
###.GGG.......
....G.G.......
....###.......
1.........A...
##############
