..............
........G..X..
.C......-----.
####..........
.....D...GGG..
G.G.---..G.G..
G.G......###..
---.GGG.......
......B.......
....-----.....
1.........A...
##############
